SO ./texture/SO.xpm  



WE ./texture/WE.xpm
NO ./texture/NO.xpm
EA ./texture/EA.xpm
C 150,150,255
F 112,000001,110


        1111111111111111111111111
        100000000110000000000001
        1101100001110000000000001
        1001000000000000000000001
111111111011000001110000000000001
100000000011000001110111111111111
111110111111111011100000010001
111110111111111011101010010001
11000000110101011100000010001
1000000000000001100000010001
10000000000000001101010010001
100000111010101111101111000111
1111111 1110101 101111010001
111111111111111111111111111
11

