C   150,150,255
F	100,000001,100

SO  ./texture/SO.xpm
NO	./texture/NO.xpm
WE	./texture/WE.xpm
EA	./texture/EA.xpm


1111111111111111111111111111111
1000000000000000000000000000001
1000000000000000000000000000001
1000000000000000000000000000001
1000000000000000010000000000001
1000000000000100001000000000001
100000000000010E000000000000001
1000000000000100000000000000001
1000000000000000000000000000001
1000111000000000000000000000001
1000001000000000000001110000001
1000001000000000000001000000001
1000000000000000000001000000001
1000000000000000000000000000001
1000000000000000000000000000001
111111111111111111111111111111