C	1,102,204
F	0,102,51

SO ./texture/so.xpm
NO	./texture/no.xpm
WE	./texture/we.xpm
EA	./texture/ea.xpm
	
1111111111111111111111111111111
111111111110000000000000000001
1000000000000000000000000000001
1000000000000000000000000000001
10000000000000S0010000000000001
1000000000000100001111111100001
1000000000000100000000000000001
1000000000000100001111111100001
1000000000000000000000000000001
1000111000000000000000000000001
111111111111111111111111111111
